A Dil Se Dil Mila Le	Khammaj	more info.
A Laut Ke Ajaa Mere Meet	Madhmat Sarang	more info.
Aa Neele Gagan Tale Pyar	Bhimpalasi	more info.
Aage Bhi Jaane Na Tu	Pahadi	more info.
Aaj Dil Pe Koi Zor Chalta Nahin	Charukesi	more info.
Aaj Gaavat Man Mero Jhumke	Desi	more info.
Aaj Ki Raat Mere Dil Ki Salami Le Le	Pahadi	more info.
Aaj Ki Raat Piya Dil Na Todo	Pahadi	more info.
Aaj Ki Raat Badi Shokh Badi Natkhat Hai	Pilu	more info.
Aaj Mere Man Sakhi Bansuri Bajaye Koi	Bhimpalasi	more info.
Aaja Bhanvara Suni Dagar	Brindavani Sarang	more info.
Aaja Raja Leke Barat Aaja	Pahadi	more info.
Aaja Re, Tujhko Mera Pyar Pukare	Pahadi	more info.
Aaja Re, Aaja Re O Mere Dilvar Aaja	Pahadi	more info.
Aaji Ruth Kar Ab Kahan Jaiega	Desh	more info.
Aap Ke Anurodh Pe Main Ye Geet	Kalyan	more info.
Aap Ki Ankhon Men Kucch Mahake Hue Se Raaz Hai	Kedar	more info.
Aap Ki Nazaron Ne Samjha	Adana	more info.
Aap Ki Yaad Aati Rahi, Raat Bhar	Bhairavi	more info.
Aap Ko Pyar Chupane Ki Buri Adat Hai	Desh	more info.
Aap Yun Hi Agar Humse Milte Rahe Dekhiye Ek Din Pyaar Ho Jaayega	Kedar	more info.
Aapne Jeevan Ki Uljhan Ko	Ahir Bhairav	more info.
Aavaz Deke Hame Tum Bulao	Shivaranjani	more info.
Aaya Hai Mujhe Phir Yad	Bhairavi	more info.
Aaye Ho Meri Zindagi Me	Kalyan	more info.
Aaye Sur Ke Panchhi Aaye	Malkauns	more info.
Aayo Prabhat	Bhatiyar	more info.
Ab Kahan Jayen Ham	Darbari Kanada	more info.
Ab Ke Baras Bhejo Bhaiya Ko Babul	Pilu	more info.
Ab Ke Hum Bichray	Bhupeshwari	more info.
Ab Kya Misal Dun	Khammaj	more info.
Ab Mori Vinti Suno Bhagwaan	Darbari Kanada	more info.
Ab Tere Siva	Bhairavi	more info.
Ab To Hai Tumse Har Khushi Apni	Mand	more info.
Ab To Madhava Mohe Ubar	Kaushik Kanada	more info.
Abhi Na Jao Chhodkar	Kalyan	more info.
Adha Hai Chandrama Raat Adhi	Malkauns	more info.
Ae Ajnabi Tu Bhii Kabhi Aawaz De Kahiin Se	Bhimpalasi	more info.
Ae Dunya Kya Tujh Se Kahen	Kafi	more info.
Aga Karunakara	Todi	more info.
Agar Mujhse Muhobbat Hai, Mujhe Sab Apne Gam De Do	Darbari Kanada	more info.
Ai Dil Ab Kahi Na Ja	Bhairavi	more info.
Ai Dil Beqarar Jhum	Bihag	more info.
Ai Dil Mujhe Aisi Jagah Le Chal	Adana	more info.
Ai Dil Tujhe	Bhairavi	more info.
Ai Diwali, Ai Diwali	Bhairavi	more info.
Ai Mere Dil Kahin Aur Chal	Bhairavi	more info.
Ai Mere Dost, Ai Mere Hamdam	Bhairavi	more info.
Ai Meri Johara Zabeen, Tujhe Maaloom Nahin	Pilu	more info.
Aie Katib-e-Taqdeer	Bhairavi	more info.
Aisa Lagta Hai Zindagi Tum Ho	Charukesi	more info.
Aise To Na Dekho	Gara	more info.
Aja Re, Paradesi	Bageshri	more info.
Ajaa Re Mere Pyar Ke Rahi	Janasamohini	more info.
Ajahun Na Aye Balma	Madhuvanti	more info.
Akele Hain Chale Ao	Charukesi	more info.
Albela Sajan Aayo Re	Ahir Bhairav	more info.
Albeli Naar Pritam Dwar	Bhairavi	more info.
Allah Megh De, Pani De Chaaya De Ra Rama Megh De	Pilu	more info.
Allah Tero Naam	Gaur Sarang	more info.
Although We Hail From Different Lands	Shivaranjani	more info.
Amma Roti De	Bhairav	more info.
Anewala Pal, Janewala Hai	Kirwani	more info.
Ang Ang Dole Mera	Khammaj	more info.
Ankhiyana Sang Ankhiya Lagi Aaj	Malkauns	more info.
Ankhon Se Jo Utari	Kirwani	more info.
Ansu Bhari Hai Ye Jivan Ki Rahe	Kalyan	more info.
Ansu Samjh Ke Kyun Mujhe	Kalyan	more info.
Apni Kaho Kuchh Meri Suno, Kya Dil Ka Lagana Bhul Gaye	Pilu	more info.
April Fool Banaaya	Bhairavi	more info.
Are Ja Re Hato Natakhat	Pahadi	more info.
Awara Hun Ya Gardish Mein Hun	Bhairavi	more info.
Awaz De Kahan Hain	Pahadi	more info.
Awaz Mein Na Dunga...Chahunga Main Tujhe Sanjh Savere	Pahadi	more info.
Ayo Kahan Se Ghanashyam	Khammaj	more info.
Baabul Mora, Naihar Chhooto Hi Jaaye	Bhairavi	more info.
Baad Muddat Ki Yeh Ghadi Ayi	Chayanat	more info.
Baadal Ghumad Bhar Aaye	Mian Ki Malhar	more info.
Baaki Kuchh Bacha To Menhagai Maar Gayi	Bhairavi	more info.
Baat Chalat Nayi Chunari Rang Dari	Bhairavi	more info.
Baat Meri Suniye To Zara	Gawati	more info.
Bacche Man ke Sacche	Bhairavi	more info.
Bachpan Ki Mohabbat Ko Dil Se Na Judaa Karna	Mand	more info.
Bada Dukh Dina Tere Lakhanne	Kalyan	more info.
Bada Natkhat Hai Re Krishna Kahaiya	Khammaj	more info.
Badariya Baras Gayi Us Paar	Tilak Kamod	more info.
Bade Bhole Ho	Kalyan	more info.
Badi Der Bhai Kab Loge Khabar	Pilu	more info.
Badi Dheere Jali	Lalit	more info.
Badli Badli Duniya Hai Meri	Jhinjhoti	more info.
Baharon Ki Manzil Rahi	Pahadi	more info.
Baharon Mera Jivan Bhi Sanvaro	Pahadi	more info.
Baharon Ne Mera Chaman Loot Kar	Pilu	more info.
Baharon Phul Barsao	Shivaranjani	more info.
Bainya Na Dharo	Charukesi	more info.
Bairan Ho Gai Raina	Jaijaivanti	more info.
Bairana Neend Na Aye	Kafi	more info.
Balma Aayo Baso More Manmen	Sindhura	more info.
Balma Anadi Man Bhaye	Hemant	more info.
Balma Bolo Na	Malgunji	more info.
Balma Mane Na	Malkauns	more info.
Banake Kyun Bigada Re	Shivaranjani	more info.
Bane To Ban Jaye Zamana Dushman	Bhairavi	more info.
Banke Chakori Gori, Jhum Jhum Nachegi	Bihag	more info.
Banwari Re Jeene Ka Sahara	Pilu	more info.
Barasat Men, Hamse Mile Tum	Bhairavi	more info.
Barasorey	Meg Malhar	more info.
Basant Hai Aayaa Rangeela	Basant	more info.
Basti Basti Parbat Parbat	Darbari Kanada	more info.
Bata De Sakhi Kaun Gali Gayo Shyam	Pahadi	more info.
Be-Sabab Baat Badhaneki Zaroorat Kya Hai	Kirwani	more info.
Bedardi Balama	Charukesi	more info.
Bedardi Dagabaz Ja Tu Nahin Balma Mora	Bageshri	more info.
Bekas Pe Karam Kijie	Kedar	more info.
Bekhudi Mein Sanam	Charukesi	more info.
Bemuravvata Bewafa	Shankara	more info.
Beqaraar Dil, Tu Gaye Jaa	Kirwani	more info.
Beqasi Had Se Jab Guzar Jaye	Desh	more info.
Beshaq Mandir Masjid Tode	Bhairavi	more info.
Bhajan Bina Chain Naa Aye Ram	Janasamohini	more info.
Bhari Duniya Men Akhir Dil Ko Samajhane Kahan Jaayen	Bhairavi	more info.
Bhaye Bhanjana...Darasa Tere Mange Main Tera Pujari	Mian Ki Malhar	more info.
Bheega Bheega Mausam Aaya, Barse Ghata Ghanghor	Shivaranjani	more info.
Bhini Bhini Bhor Aayi	Mian Ki Todi	more info.
Bhooli Bisri Chand	Kedar	more info.
Bhor Ayi, Gaya Andhiyara	Alhiya Bilawal	more info.
Bhor Bhaye	Gujari Todi	more info.
Bhor Bhaye Panghat Pe	Bhairavi	more info.
Bhuli Hui Yadon	Kalyan	more info.
Bin Barish Barsaat Na Hogi	Madhmat Sarang	more info.
Bina Madhur Madhur Kachhu Bol	Bhimpalasi	more info.
Biraj Me Holi Khelat Nand Lal	Kafi	more info.
Bol Radha Bol Sangam Hoga Ke Nahin (A.K.A. Mere Man Kii Ganga	Bhairavi	more info.
Bole Re Papihara, Papihara	Mian Ki Malhar	more info.
Boliye Surili Boliyan	Bihag	more info.
Bole To Basuri Kahi	Kedar	more info.
Bolo Bolo Kanha Bolo Chaliya	Shankara	more info.
Brindavan - see also Vrindavan	 	 
Chaahat Des Se Aane Waale Yeh To Bataa Ke Sanam Kaise Hain	Pilu	more info.
Chad Gayo Paapi Bichua	Madhumat Sarang	more info.
Chadariya Jhini Re Jhini	Desh	more info.
Chadta Suraj Dheere Dheere	Bhupeshwari	more info.
Chah Barbad Karegi	Bageshri	more info.
Chahe Koi Mujhe Jangli Kahe	Bhairavi	more info.
Chaina Nahin Aye, Kahan Dil Jaye	Chayanat	more info.
Chal Ud Ja Re Panchi	Pahadi	more info.
Chala Diye Deke Gam	Nayaki Kanada	more info.
Chale Jana Nahin Naina Milake	Asavari	more info.
Chalenge Tir Jab Dil Par	Bihag	more info.
Chali Gori Pi Se Milan Ko Chali	Bhairavi	more info.
Chali Re Chali Re Mai To Des Paraye	Tilak Kamod	more info.
Chaliya Mera Naam	Bhairavi	more info.
Chalo Chale Mitwa	Gawati	more info.
Chalo Dildar Chalo	Pahadi	more info.
Chalo Man Jayen Ghar Aapne	Ahir Bhairav	more info.
Chalo Sajna Jhaan Tak	Basant Mukhari	more info.
Chaman Men Rang-e-Bahar Utara To Maine Dekha	Bageshri	more info.
Chand Phir Nikala	Shuddha Kalyan	more info.
Chanda Hai Tu, Mera Suraj Hai Tu	Bhupali	more info.
Chanda Re Mori Patiya Le Ja	Durga	more info.
Chanda Re, Ja Re Ja Re	Chayanat	more info.
Chandan Ka Palna Resham Ki Dori	Pilu	more info.
Chandan Sa Badan Chanchal Chitavan	Kalyan	more info.
Chandi Ki Divar Na Todi	Darbari Kanada	more info.
Chaudavin Ka Chand Ho Ya Aftab Ho	Pahadi	more info.
Chham Chham Nachat Ayi Bahar	Bahar	more info.
Chheda Diye Mere Dil Ke Tara Ko	Kamod	more info.
Chhod De Saari Duniya Kisi Ke Liye	Charukesi	more info.
Chhod Gaye Balam	Bhairavi	more info.
Chhup Gaya Koi Re Door Se Pukar Ke	Jhinjhoti	more info.
Chhupa Lo Yun Dil Men Pyar Mera	Kalyan	more info.
Chingari Koi Bhadke	Bhairavi	more info.
Chitanandan Aage Nachungi	Jaunpuri	more info.
Chota Sa Baalama Ankhiyan Neend Udaye Le Gayo	Tilang	more info.
Chori Chori Koi Ae	Pahadi	more info.
Chuma Chuma...Mujhko Bana Le Priyatama	Shivaranjani	more info.
Chunariya Katati Jae	Khammaj	more info.
Chup Gaya Badli Mein	Pahadi	more info.
Chura Liyaa Hai Tumne Jo Dil Ko	Pilu	more info.
Dairo Haram Men Basne Waalon	Gaur Sarang	more info.
Daiya Re Daiya Laj Mohe Lage	Darbari Kanada	more info.
Dar Lage Garaje Badariya	Sur Malhar	more info.
Darashan Do Ghanashyam Naath Morii Ankhiyan Pyasi Re	Kedar	more info.
Darbar Mein Upar Wale Ke	Malkauns	more info.
Daya Karo e Giridhar	Multani	more info.
De De Pyar De	Pilu	more info.
Deep Jalaye Jo Geeton Ke Maine	Malkauns	more info.
Dekha Ek Khvab To Yeh Silsile Hue	Bhupali	more info.
Dekha Hai Pehli Baar	Darbari Kanada	more info.
Dekho Bijlee Dole	Basant Mukhari	more info.
Dekho Jadu Bhare More Naina	Gaur Sarang	more info.
Desh - Pardesh	Shankara	more info.
Dhadakate Dil Ki Tamanna	Pilu	more info.
Dhak Dhak Karne Laga	Shivaranjani	more info.
Dhal Chuki Sham-e-Gham	Khammaj	more info.
Dhanya Bhag Seva Ka Avsar Paaya	Bhairavi	more info.
Dheere Se Aaja Ri Akhiyan Mein Nindiya Men	Pilu	more info.
Dhire Dhire Subah Hui He Jag Uthi Zindag	Ahir Bhairav	more info.
Dhoondho Dhoondho Re Saajna	Pilu	more info.
Dil Aaj Shair Hai	Bhairavi	more info.
Dil Apna Aur Prit Paraiyi	Bhairavi	more info.
Dil Ched Koi Aisa Nagma	Jaunpuri	more info.
Dil Dance Mare	Bhairavi	more info.
Dil Diya Dard Liya	Kalyan	more info.
Dil-e-Betab Ko Sine Se	Kalyan	more info.
Dil Ek Mandir Hai	Jogiya	more info.
Dil Hun Hun Kare	Bhupali	more info.
Dil Jalta Hai To Jalane De	Darbari Kanada	more info.
Dil Jo Bhi Kahega Manenge	Kalyan	more info.
Dil Jo Na Kahe Saka	Maru Bihag	more info.
Dil Ka Diya Jalaya	Jaijaivanti	more info.
Dil Ka Khilona Haye Tut Gaya	Bhairavi	more info.
Dil Ke Jharokhe Mein Tujhko Bithakar	Shivaranjani	more info.
Dil Ke Tukade Tukade	Bhimpalasi	more info.
Dil Ki Kashti	Gorakh Kalyan	more info.
Dil Mein Ek Lahar Si Uthi Hai Abhi	Pahadi	more info.
Dil Mein Ho Tum Ankhon Mein Tum	Jaunpuri	more info.
Dil Mein Tujhe Bithake	Bhimpalasi	more info.
Dil Men Aur To Kya Rakha Hai	Kalavati	more info.
Dil Pukare Are Are	Pahadi	more info.
Dil Se Re	Jog	more info.
Dil Todnewale	Pahadi	more info.
Din Hai Bahar Ke Tere Mere	Pahadi	more info.
Din Sara Guzara Tore Angana	Pilu	more info.
Divane Tum, Divane Hum	Bageshri	more info.
Diwana Kahe Ke Aaj Mujhe Phir Pukariye	Gara	more info.
Diya Jalao Jagmag Jagmag	Kalyan	more info.
Diya Na Bujhe Ri Aaj Hamara	Bhairavi	more info.
Do Dil Dhadak Rahe Hain Aur Avaz Ek Hai	Pahadi	more info.
Do Dil Tute Do Dil Hare	Pahadi	more info.
Do Hanson Ka Joda Bichhad Gayo Re	Bhairavi	more info.
Do Naina Matavare Tihare	Kalyan	more info.
Do Sitaron Ka Zamin Pe Hai Milan Aaj Ki Rat	Pahadi	more info.
Doli Chadhte (Hi) Heer	Bhairavi	more info.
Dost Ban Kar Bhi Nahin Saath Nibhanevala	Jaijaivanti	more info.
Dost Dost Na Raha	Bhairavi	more info.
Dukh Ke Ab Din Bitat Nahi	Desh	more info.
Dukh Ki Laharne Cheda Hoga	Charukesi	more info.
Dukha Bhare Din Bite Re Bhaiya	Megh Malhar	more info.
Duniya Badal Gayi	Darbari Kanada	more info.
Duniya Banane Wale Kya Tere Man	Bhairavi	more info.
Duniya Na Bhaye Mohe, Ab To Bulale	Todi	more info.
Duniya Se Ji Ghabra Gaya	Bhimpalasi	more info.
E Husn-E-Beparvah Tujhe Shabnam Kahun, Shola Kahun	Kirwani	more info.
Ehasaan Tera Hoga Mujhapar	Kalyan	more info.
Ek - see also Ik	 	 
Ek Bas Tu Hi Nain	Mian Ki Malhar	more info.
Ek Dil Aur Sau Afsane	Bhairavi	more info.
Ek Radha Ek Meera	Kirwani	more info.
Ek Ritu Aye Ek Ritu Jaye	Bhairav	more info.
Ek Saathi Aur Bhi Tha	Gawati	more info.
Ek Shahenshah Ne Banvaa Ke Hasin Tajmahal	Lalit	more info.
Ek Tha Bachapan	Gujari Todi	more info.
Ek Tu Jo Mila	Charukesi	more info.
Eli Re Eli Kya Hai ye Paheli	Bhimpalasi	more info.
Eri Ali Piya Bina	Kalyan	more info.
Eri Jane Na Dungi	Kamod	more info.
Eri Main To Prem Divani (#1)	Bhimpalasi	more info.
Eri Main To Prem Divani (#2)	Todi	more info.
Garajat Barsat Bheejata Ailo	Gaur Malhar	more info.
Gaya Andhera Hua Ujala	Pahadi	more info.
Geet Gata Hun Main Gunagunata Hun Main	Kirwani	more info.
Geet Gaya Pattharon Ne	Durga	more info.
Ghadi Ghadi Mora Dil Dhadke	Bageshri	more info.
Ghanan Ghanan	Pilu	more info.
Ghar A Jaa Ghir Aye Badra Sanvareya	Malgunji	more info.
Ghar Aya Mera Pardesi	Bhairavi	more info.
Ghar Se Nikalte Hi Kuch Door Chalate Hi	Kalyan	more info.
Gharib Jaan Ke Ham Ko Na Tum daga Dena	Bhairavi	more info.
Gharibon ki Suno (a.k.a. Chaahe Laakh Karo Tum Puja	Bhairavi	more info.
Ghata Ghanaghor Ghor	Brindavani Sarang	more info.
Ghayal Hiraniya	Kafi	more info.
Ghungharu Ki Taraha, Bajta hi Raha Hun Main	Jhinjhoti	more info.
Ghunghat Ke Pat Khol	Jaunpuri	more info.
Giridhar Gopala	Bhupali	more info.
Gori Gori Gaon Ki Gori Re	Tilang	more info.
Gori Tera Gaun Bada Pyara	Palasi	more info.
Gori Tore Naina, Nainava Kajar Bin Kare Kare	Desh	more info.
Gori Tori Banki - see O Gauri Tori Banki	 	 
Gudiya Hamse Ruthi Rahogi	Pahadi	more info.
Guzre Hain Aaj Ishq Men,	Darbari Kanada	more info.
Hai Chaand Sitaaron Men Chamak Tere Badan Ki	Bhimpalasi	more info.
Hai Hai Rasiya Tu Bada Bedardi	Pilu	more info.
Hai Rama Yeh Kya Hua	Puria Dhanashri	more info.
Hai Re Hai	Brindavani Sarang	more info.
Ham Apna Unhe Bana Na Sake	Khammaj	more info.
Ham Bekhudi Men Tumko Pukare Chale Gaye	Chayanat	more info.
Ham Jab Simata Ke Aapki Bahonmen	Pahadi	more info.
Ham Kashma Kashe Se Gam Se Guzar Kyu Nahi Jaate	Gunkali	more info.
Ham Kisi Se Kam Nahin	Kalavati	more info.
Ham Tujh Se Muhabbat Kar Ke	Darbari Kanada	more info.
Ham Tum Se Juda Ho Ke	Darbari Kanada	more info.
Ham Tum Se Na Kuchh Kah Paaye, Tum Ham Se Na Kuchh Kah Paaaye	Bhupali	more info.
Hamare Dil Se Na Jana, Dhokha Na Khana	Bihag	more info.
Hamari Sansoo Me Aaj Tak Woh Hina Kis Kshboo	Kafi	more info.
Hamari Yad Aayegi, Kabhi Tanhaiyon Men	Palasi	more info.
Hame Tumse Pyar Kitana	Bhairavi	more info.
Hamko Hone Laga Hai Pyaar Tumse	Bhupal Todi	more info.
Hamko Man Ki Shakti Dena	Kedar	more info.
Hamen Koi Gham Nahin Tha, Gham-e-Ashiqi Se Pahle	Ahir Bhairav	more info.
Hamne To Dil Ko Aapke Kadamon Pe	Pahadi	more info.
Hamne Tujhko Pyar Kiya Hai Jitna	Tilak Kamod	more info.
Hamsafar Saath Apna Chhod Chale	Gara	more info.
Hamse Aya Na Gaya	Bageshri	more info.
Hangama Hai Kyon Barpa	Darbari Kanada	more info.
Hanse Tim Tim	Bhairav	more info.
Har Ek Baat Pe	Kalyan	more info.
Har Waqt Tere Husn Ka	Kedar	more info.
Hato Kaheko Juthi Banao Batiyaan	Bhairavi	more info.
Haye Re Wo Din Kyun Naa Aaye	Janasamohini	more info.
Haye Ve Dilbar Dildara	Brindavani Sarang	more info.
He Aag Hamare Sine Mein	Bhairavi	more info.
He Govind, He Gopal, He Dayaal Lal	Bhupali	more info.
He Natraja Gangadhar Shambho Bolenath	Jogiya	more info.
Hiya Jarat Rahat Din Rain	Tilak Kamod	more info.
Ho Gaye Do Rooj...Wafa Jinse Ki	Tilak Kamod	more info.
Holi Khelat Nand Lal - see Biraj Men Holi Khelat Nand Lal	 	 
Hori Ho Brijaraja Dulare	Kafi	more info.
Hoton Pe Sachhayi Rahati Hai	Bhairavi	more info.
Hum . . . . . - see Ham	 	 
Huq Ali	Bhairagi Bhairav	more info.
Hushn Pahadon Ka	Pahadi	more info.
Ik - see also Ek	 	 
Ik sitam aur meri jaan abhi jaan baqi hai	Kafi	more info.
Iktaara Bole	Bhairavi	more info.
In Ankhon Ki Masti Ke Mastane Hazaron Hai	Bhupali	more info.
Inhi Logon Ne Le Lina Dupatta Mera	Kalyan	more info.
Insaf Ka Mandir Hai, Yeh Bhagavan Ka Ghar Hai	Bhairavi	more info.
Insan Bano	Todi	more info.
Intazaar Aur Abhi	Kalyan	more info.
Is Bhari Duniyan Men	Bhairavi	more info.
Is Mod Se Jate Hai	Kalyan	more info.
Isharon Isharon Mein Dil Lenewale	Pahadi	more info.
Ishq Ki Garmi-e-Jazabaat Kise Pesha Karun	Kafi	more info.
Itna To Yaad Hai Mujhe	Tilang	more info.
Ja Re Badra Bairi Ja	Kalyan	more info.
Ja Re, Beiman Tujhe Jan Liya	Bageshri	more info.
Ja Tose Nahin Bolun Kanhaiya	Hamsadhwani	more info.
Jaa Jaa Re Jaa, Balmava	Jhinjhoti	more info.
Jaa Re, Jaa Re Ud Jaa Re Panchhi	Bhairavi	more info.
Jaa-Jaa Re Ai Pathikwa	Gujari Todi	more info.
Jaadugar Katil	Bhairavi	more info.
Jaadugar Sainyan	Brindavani Sarang	more info.
Jaag Dard-e-Ishq Jaag	Bageshri	more info.
Jaago, Mohan Pyare Jaago	Bhairav	more info.
Jaan-E-Jaana...Jab Jab Teri Surat Dekhun	Charukesi	more info.
Jaane Bahaar Husn Tera	Malkauns	more info.
Jaane Kahan Gaye Woh Din	Shivaranjani	more info.
Jaane Kaise Sapanon Main Kho Gayi Ankhiyan	Manj Khammaj	more info.
Jaane Kya Dhundti Rahati Hain	Pahadi	more info.
Jaane Kyon Log Pyar Karte Hai	Nattakarunji	more info.
Jaanewalon Zara Mud Ke Dekho Mujhe	Pahadi	more info.
Jab Dil Hi Tut Gaya	Bhairavi	more info.
Jab Dil Ko Satae Gam	Devagandhari	more info.
Jab Dip Jale Ana	Kalyan	more info.
Jab Tum Hi Hame	Todi	more info.
Jadoo Teri Nazar, Khusboo Tera Badan	Asawari	more info.
Jag Mein Sunder Hai Do Naam, Chahe Krishna Kaho Ya Ram	Todi	more info.
Jago Re Jago Prabhat Aya	Todi	more info.
Jahaan Daal Daal Par Sone Ki Chidiyaan Karti Hain Basera	Shuddha Kalyan	more info.
Jaiye Aap Kahan Jayenge	Pilu	more info.
Jaise Radha Ne	Bhairavi	more info.
Jalte Hain Arman Mera Dil Roota Hai	Kafi	more info.
Jana Gana Mana	Alhiya Bilawal	more info.
Janevale Se Mulakat Na Hone Payi	Kalyan	more info.
Jao Jao Nand Ke Lala	Bageshri	more info.
Jao Re Jogi Tum Jao Re	Kamod	more info.
Jara ... see zara	 	 
Jaun Kahan Bata E Dil	Jhinjhoti	more info.
Jaun Tore Charan Kamal Par Vari	Bhupali	more info.
Javaan Hai Muhabbat	Pahadi	more info.
Jay Bolo Beiman Ki	Bhairavi	more info.
Jay Jay He Jagadambe Mata	Kalyan	more info.
Jay Radha Madhav Jai Kunjbihari	Darbari Kanada	more info.
Jaya Nandlala	Bhatiyar	more info.
Jaye To Jayen Kahan Samjhe Ga Kaun Yahan	Jaunpuri	more info.
Jeet Hi Lenge	Bhairavi	more info.
Jeevan - see Jivan	 	 
Jhan Jhan Jhan Jhan Payal Baje	Chayanat	more info.
Jhanak Jhanak Paayal Baaje	Adana	more info.
Jhanak Jhanak Tori Baje Payeliya	Darbari Kanada	more info.
Jhananana Jhan Baje Payaliya	Brindavani Sarang	more info.
Jhanakar Payala Ki Tose Binati Kare	Bhimpalasi	more info.
Jhir Jhir Barase Savani Ankhiyan	Gaur Malhar	more info.
Jhoothe Naina Bole Sanchi Bateeyan	Bilaskhani Todi	more info.
Jhule Mein Pavan Ki Ayi Bahar	Pilu	more info.
Jhulana Jhulao	Devagandhari	more info.
Jhula Jhulo Re	Gaur Sarang	more info.
Jhumati Chali Hava	Sohani	more info.
Jhuthi Muthi Batiya Avan Bole	Brindavani Sarang	more info.
Jina Yahan Marna Yahan	Bhairavi	more info.
Jis Dil Me Basa Tha Pyaar Tera	Bhairavi	more info.
Jis Din Se Piya	Todi	more info.
Jivan Dor Tumhi Sang Bandhi	Kalyan	more info.
Jivan Se Bhari Teri Ankhen	Malgunji	more info.
Jivan Se Na Har O Jeenewale	Pahadi	more info.
Jivan Jyot Jale	Sohani	more info.
Jivan Men Piya Tera Sath Rahe	Gara	more info.
Jiya Le Gayo Ji Mora Sanvariya	Kalyan	more info.
Jiyo To Aise Jiyo	Kalyan	more info.
Jo Bhaje Hari Ko Sada	Bhairavi	more info.
Jo Me Jaanthi Bisarat	Mand	more info.
Jo Tum Todo Piya	Bhairavi	more info.
Jo Vada Kiya Vo	Pahadi	more info.
Jogi Aaya, Jogi Aaya, Jogi Aaya Re	Darbari Kanada	more info.
Jurm-e-Ulfat Pe	Gaur Malhar	more info.
Jyot Se Jyot Jagate Chalo	Bhairavi	more info.
Jyoti Kalash Chalke	Bhupali	more info.
Kaali Ghodi Dwar Khadi	Kafi	more info.
Kaanha Kanha Aan Padi Re Tere Dwar	Manj Khammaj	more info.
Kaare Kaare Badra, Jaare Jaare Badara	Brindavani Sarang	more info.
Kaare Kaare Badra, Suni Suni Ratiya	Megh Malhar	more info.
Kabhi Aar Kabhi Paar	Pilu	more info.
Kabhi Dil Dil Se Takarata To Hoga	Darbari Kanada	more info.
Kabhi Kabhi Mere Dil Men	Pahadi	more info.
Kabhi Khud Pe Kabhi Haalaath Pe Ronaa Aayaa	Gara	more info.
Kabhi Neki Bhi Uske Ji Men Gar Aa Jaye Hai Mujhse	Bhairavi	more info.
Kabhi To Milegi - see Baharon Ki Manzil Rahi	 	 
Kadam Chale Age	Desh	more info.
Kah Do Koi Na Kare Yahan Pyaar	Jogiya	more info.
Kahan Jaate Ho Toota Dil Hamara	Hamsakinkini	more info.
Kahan Se Aye Badra	Megh	more info.
Kahe Gumana Kare	Pilu	more info.
Kahe Jhum Jhum Raat Ye Suhani	Kirwani	more info.
Kahe Sataye Kaheko Rulaye	Pahadi	more info.
Kahe Tarasae Jiyara	Kalavati	more info.
Kaheta Hai Joker	Bhairavi	more info.
Kahin Deep Jale Kahin Dil	Shivaranjani	more info.
Kai Sadiyon Se Kai Janmon Se	Shivaranjani	more info.
Kaise Aau Jamuna Ke Tir	Bhairavi	more info.
Kaise Dina Bite Kaise Biti Ratiyan Piya Jane Na	Manj Khammaj	more info.
Kaise Jiyunga Main Ho	Pahadi	more info.
Kaisa Jadoo Balama Tune	Pilu	more info.
Kaise Kahen Ham	Tilang	more info.
Kaise Kahun Man Ki Bata	Kafi	more info.
Kaise Kate Rajani	Bageshri	more info.
Kaise Samjhaun Bade Na Samajh Ho	Bhairavi	more info.
Kali Ghata Chhaye Mora Jiya Tarasaye	Pilu	more info.
Kanha Ja Re	Kedar	more info.
Kanha Re Kanha	Sohani	more info.
Kanchi Re Kanchi Re	Bhupali	more info.
Karam Ki Gati Nyari	Hamsadhwani	more info.
Karavate Badalte Rahe Sari Raat Ham	Pahadi	more info.
Kariye Na	Gawati	more info.
Karo Sab Nichhavar	Mian Ki Malhar	more info.
Karuna Suno Shyam Mori	Purvi	more info.
Kaun Aya Ke Nigahon Mein Chamak Jag Uthi	Pahadi	more info.
Kaun Aya Mere Man Ke Dvare	Rageshri	more info.
Kehta Hai Mera Yeh Dil	Bhimpalasi	more info.
Kenu Sang Khelun Holi	Kalyan	more info.
Kesariya Balma	Mand	more info.
Ketaki, Gulab, Juhi Champaka Bana Phule	Basant Bahar	more info.
Khabar Meri Naa Lini Re Bahut Din Bite	Shivaranjani	more info.
Khamosh Hai Khevana Hara Mera	Bhairavi	more info.
Khamosh Raat	Anandbhairavi	more info.
Khanabadosh	Bhimpalasi	more info.
Khat Likh De Savariya Ke Naam Babu	Khammaj	more info.
Khayi Hai Re Hamne Kasam Sang Rahne Ki	Barawa	more info.
Khilate Hain Gul Yahan	Bhimpalasi	more info.
Khuda E Baratar Teri Zamin Par	Todi	more info.
Khushiyon Ke Chand	Bhairavi	more info.
Kisi Baat Par Main	Bhairavi	more info.
Kisi Ki Yaad	Kedar	more info.
Kisi Nazar Ko Tera Intazar Aja Bhi Hai	Bhairavi	more info.
Kisi Ne Apna Bana Ke	Bhairavi	more info.
Kisi Raha Men Kisi Mod Par	Charukesi	more info.
Kismat Se Tum Ham Ko Mile Ho	Bhimpalasi	more info.
Kitane Dino Ke Baad Ye Aai Sajana Rat Milan Ki	Puria Dhanashri	more info.
Kitna Hasin Hai Mausam	Darbari Kanada	more info.
Ko Birahini Ko Dukh Jane	Madhuvanti	more info.
Koi Gata, Main So Jata	Bihag	more info.
Koi Hamdam Na Raha, Koi Sahara Na Raha	Jhinjhoti	more info.
Koi Jab Tumhara Hriday Tood De	Charukesi	more info.
Koi Matwala Ayaa Mere Dware	Darbari Kanada	more info.
Koi Paas Aya Savere Savere	Lalit	more info.
Koi Pyara Ki Dekhe Jadugari	Pahadi	more info.
Koi Sagar Dil Ko Behlata Nahin	Janasamohini	more info.
Konpalen Phir Fut Ayi	Megh	more info.
Kora Kagaz Tha Man Mera	Pahadi	more info.
Koyaliya Ud Ja Yahan Nahi Koya (a.k.a. Koyaliya Tere Bol)	Puria Dhanashri	more info.
Kuch Aur Zamana	Gaur Sarang	more info.
Kuch Dil Ne Kaha	Bhimpalasi	more info.
Kuch To Log Kahenge	Khammaj	more info.
Kuhu Kuhu Bole Koyaliya	Sohani	more info.
Kya Saath Mera Doge Tum Pyar	Kalyan	more info.
Labon Se Chumlo, Aankhon Se Thaamlo Mujh Ko	Puria Dhanashri	more info.
Lag Jaa Gale	Pahadi	more info.
Laga Gayeen Akhiyan	Multani	more info.
Laga, Chunari Mein Daag	Bhairavi	more info.
Lagan Tose Lagi Balma	Tilang	more info.
Lage Na Mora Jiya, Sajna Nahin Aye Haye	Shivaranjani	more info.
Lagta Nahin Hai	Kalyan	more info.
Lal Chhadi Maidan Kadi	Bhairavi	more info.
Lapak Jhapak	Megh Malhar	more info.
Lat Uljhi Suljha Ja Re Baalam	Kafi	more info.
Lau Lagati Geet Gaati	Kalyan	more info.
Leheron Mein Jhoolun	Gaur Sarang	more info.
Lo Aa Gayi Unki Yaad , Wo Nahi Aaye	Asavari	more info.
Lo Phir Basant Aae	Basant	more info.
Madhuban Men Radhika Nache Re	Hamir	more info.
Madhukara Shyam Hamare Chor	Bhairavi	more info.
Madhura Madhura Sangeet	Bageshri	more info.
Mahefil Men Baar Baar Kisi Par Nazar Gai	Megh	more info.
Mai Ri Main, Kaise Jiyun Ri	Ahir Bhairav	more info.
Mai To Ek Khvaab Hun	Todi	more info.
Maika Piya Bulave	Kalavati	more info.
Maikhana Piye Ja Yunhi, Deewana Piyeja	Bageshri	more info.
Main Chali Main Chali	Bhairavi	more info.
Main Garibon Ka Dil	Bhimpalasi	more info.
Main Kya Janun Kya Jadu Hai	Kalyan	more info.
Main Nigahen Tere Chehare se Hataun Kaise	Darbari Kanada	more info.
Main Pagal Mera Manawa Pagal	Kedar	more info.
Main Pyar Ka Rahi Hun	Kirwani	more info.
Main Soya Ankhian Meeche	Pilu	more info.
Main To Kabse Teri Sharan Men Hun	Ahir Bhairav	more info.
Main To Pyaar Se Teri Piya Mang Sajaungi	Bhairavi	more info.
Maine Chand Aur Sitaron Ki	Bhimpalasi	more info.
Maine Rang Li Aaj Chunariya Sajana Tore Rang Me	Pilu	more info.
Maine Shayad Tumhen, Pahle	Pilu	more info.
Mainu Ishq Da Lag Gaya Rog	Pilu	more info.
Man Anand Anand Chhayo	Ahir Bhairav	more info.
Man Ki Bin Matavari Baje	Bahar	more info.
Man Mor Hua Matavala	Bhimpalasi	more info.
Man Re Tu Kahe Na Dhir Dhare	Kalyan	more info.
Man Tarapat Hari Darshan Ko	Malkauns	more info.
Mana Bhavana	Brindavani Sarang	more info.
Mana Mere Haseen Sanam	Desh	more info.
Mana Re Hari Ke Guna	Bhairav	more info.
Mane Na	Rageshri	more info.
Mangne Se	Kalyan	more info.
Manmohan Man Men Ho Tumhi	Adana	more info.
Manmohana Bade Jhuthe	Jaijaivanti	more info.
Mat Maro Shyam Pichkari	Pilu	more info.
Mata Saraswati Sharda Vidya Dayi Dayani	Bhairavi	more info.
Matawali Naar Thumak Thumak	Maru Bihag	more info.
Masoom Chehra	Bhimpalasi	more info.
Mausam Hai Ashiqaana	Kalyan	more info.
Megha Chhaye Adhi Rat	Patdeep	more info.
Megha Re Megha Re...	Charukesi	more info.
Mehendi Lagi Mere Hath Re	Bhairavi	more info.
Mein Apne Aap Se Ghabra Gaya Hoon (a.k.a. Mujhe Zindagi Divana Kar De)	Tilang	more info.
Mein Ek Raja Hun	Bhairagi Bhairav	more info.
Mein Piya Teri Tu Maane Ya Maane	Bhairavi	more info.
Mein Zindigi Men Hardam, Rota Hi Raha Hoon	Bhairavi	more info.
Mera Desh Ki Dharti, Sona Ugale Ugale Hire Moti	Bhairavi	more info.
Mera Dil Yeh Pukare Aaja	Kirwani	more info.
Mera Juta Hai Japani	Bhairavi	more info.
Mera Naam Raju	Bhairavi	more info.
Mera Pyar Bhi Tu Hai Yeh Bahar Bhi Tu Hai	Pilu	more info.
Mera Rang De Basanti Chola	Bhairavi	more info.
Mere Ai Dil Bata	Bhairavi	more info.
Mere Ankhon Mein Bas Gaya Koi Re	Pahadi	more info.
Mere Hamsafar, Mere Hamsafar (a.k.a. Kisi Raha Men Kisi Mod Par)	Charukesi	more info.
Mere Hamsafar Mere Hamsafar Mere Paas Aa Mere Paas Aa	Kalyan	more info.
Mere Khwabon Ka Har Aik Naksh	Bhairavi	more info.
Mere Maheboob Tujhe Meri Muhabbat Ki Qasam	Jhinjhoti	more info.
Mere Man Ka Bavara Panchhi	Bhimpalasi	more info.
Mere Mehboob Shayad Aaj Kuchh	Darbari Kanada	more info.
Mere Naina Savan Bhaando	Shivaranjani	more info.
Mere Pyar Men	Desh	more info.
Mere Sang Ga Gunguna	Rageshri	more info.
Mere To Giridhara Gopala	Khammaj	more info.
Meri Bhigi-Bhigi Si Palakon Pe Rah Gaye	Kirwani	more info.
Meri Duniya Mein Tum Aaye	Kalyan	more info.
Meri Kahani Bhulnevale Tera Jahan Abad Rahe	Tilang	more info.
Meri Ladli Re, Meri Ladli	Bihag	more info.
Meri Laj Rakho Giridhari	Shivaranjani	more info.
Meri Muhabbat Javan Rahegi	Shuddha Kalyan	more info.
Meri Saanson Ko Jo Mahaka Rahi Hai	Puria Dhanashri	more info.
Meri Tanhaiyon Tum Hi Lagalo Mujhko Sinese	Bhairavi	more info.
Meri Vina Tum Bin Roye	Ahir Bhairav	more info.
Meri Yad Men Tum Na Ansu Bahana	Jaunpuri	more info.
Mil Ja Re Jane Jana	Kedar	more info.
Mile Jo Kadi Kadi, Ek Zanjeer Bane	Bhairavi	more info.
Mile Sur Tera Hamara	Bhairavi	more info.
Milne Ka Din Aa Gaya	Desh	more info.
Mitava Laut Aye Ri	Darbari Kanada	more info.
Mithe Bol Bole	Bhairavi	more info.
Mitwa Re Mitwa Purab Na Jaio	Bhairavi	more info.
Mohabbat Ke Suhane Din, Javani Ki Hansi Raaten	Charukesi	more info.
Mohabbat Ki Dastan	Bhairavi	more info.
Mohe Bhul Gaye Sanvariya	Bhairav	more info.
Mohe Jana Hai Pike Nazariya	Pahadi	more info.
Mohe Panghat Pe Nandalal Ched Gayo Re	Gara	more info.
More Kaanha Jo Aaye Palat Ke	Pilu	more info.
More Sainya Ji Utarenge Paar Nadiya Dhire Baho	Pilu	more info.
Mori Atariya Pe Kagan Bole	Pahadi	more info.
Mori Chhum Chhum Baje Payeliya	Bhairavi	more info.
Mose Chal Kiye Jaye Hai Re Hai Hai Dekho Saiyan Beiman	Jhinjhoti	more info.
Muft Huye Badnam Kisi Se Haay	Pahadi	more info.
Muhabbat Aisi Dhadkan Hai	Rageshri	more info.
Muhabbat Ki Jhuthi Kahani Pe Roye	Darbari Kanada	more info.
Mujhe Gale Se Laga Lo Bahut Udas Hun Main	Asavari	more info.
Mujhe Kuch Kehna Hai	Shivaranjani	more info.
Mujhe Mil Gayi Hai Mohabat	Tilak Kamod	more info.
Mujhe Na Bula	Malkauns	more info.
Mujhe Tumse Muhabbat Hai Magar	Pahadi	more info.
Mujhe Zindagi Divana Kar De (a.k.a. Mein Apne Aap Se Ghabra Gaya Hoon)	Tilang	more info.
Mujhko Is Raat Ki Tanhai Main	Bhairavi	more info.
Mujhse Naraz Ho To	Chayanat	more info.
Murali Bairan Bhayi Re Kanhaiya Tori	Pilu	more info.
Mushkil Hai Bahut Mushkil	Pahadi	more info.
Na Bajayi Ho Shyam	Bhairavi	more info.
Na Bole Na Bole Na Bole Re - see Radha Na Bole Na Bole	 	 
Na Dir Deem	Gaur Sarang	more info.
Na Jaiyo Pardes	Shivaranjani	more info.
Na Jaiyo Re Sautan Ghar Sainya	Abhogi Kanada	more info.
Na Jao Saiyan Chhuda Ke Baiyan	Pilu	more info.
Na Jhatako Zulf Se Pani	Pilu	more info.
Na Manu Na Manu...Dagabjaaz Tori Batiya Na Manu Re	Pilu	more info.
Na Na Na Baraso Baadal	Mian Ki Malhar	more info.
Na To Karavan Ki Taalash Hai	Kalavati	more info.
Naa, Jiyaa Laage Naa Tere Bina Mera Kahin	Malgunji	more info.
Nach Mere Mora Zara Nach	Mian Ki Malhar	more info.
Nacha Re Mayura	Mian Ki Malhar	more info.
Nache Man Mora Magan Dhig Dha Dhigi Dhigi	Bhairavi	more info.
Nadiya Kinare Harayee Aayee Kangna	Pilu	more info.
Naghma-O-Sher Ki Saughaat	Bhimpalasi	more info.
Nain Ka Chain Churakar Le Gayi	Pahadi	more info.
Naina Dwara Se	Jog	more info.
Naina Kahe Ko Lagaye	Pilu	more info.
Naina Neer Bahaye	Bhatiyar	more info.
Naina So Nain Nahin Milo	Malgunji	more info.
Nain Se Nain Milaye Rakhne Ko	Darbari Kanada	more info.
Nainheen Ko Raah Dikha Prabhu	Darbari Kanada	more info.
Nainon Men Badra Chhaye	Bhimpalasi	more info.
Nanda Nandana	Todi	more info.
Nas Nas Mein Agan	Bhairavi	more info.
Nava Kalpana, Nava Rup Se	Kalyan	more info.
Nazar Lagi Raja Tore Bungle Par	Khammaj	more info.
Neela Aasman So Gayaa	Pahadi	more info.
Neele Gagan Ke Tale	Pahadi	more info.
Neelam Ke Nabh Chhayi	Vibhas	more info.
Neele Parabton Ki Dhara	Pahadi	more info.
Neend Na Mujhko Aye	Kirwani	more info.
Nigahen Milane Ko Ji Chahata Hai	Kalyan	more info.
Nil Gagan Ki Chhaonmen	Bhupali	more info.
Nis Din Barsat Nain Hamare	Jogkauns	more info.
Nuktacheen Hai Gham-e-Dil	Kalyan	more info.
O Basanti Pavan Pagal	Basant Mukhari	more info.
O Beqarar Dil	Bhimpalasi	more info.
O Chaand Jahaan Woh Jaaye	Hamsadhwani	more info.
O Duniya Ke Rakhavale	Darbari Kanada	more info.
O Dur Ke Musaphir Hamko Bhi Sath Le Le	Pahadi	more info.
O Gauri Tori Banki	Bhairavi	more info.
O Mere Sanam, O Mere Sanam	Shivaranjani	more info.
O Nirdai Pritam	Bhimpalasi	more info.
O Pavan Veg Se Udanevale Ghode Tujh Pe Savaar Hai Jo	Malkauns	more info.
O Sajna, Barakha Bahara Ayi	Khammaj	more info.
O Shama Mujhe Funk De	Bhairavi	more info.
Paa Laagoon Kar Jori Re	Pilu	more info.
Paadave Ragamayi	Desh	more info.
Paayal Jham Jham Baaje	Sohani	more info.
Paayo Ji Maine Ram Ratan Dhan Paayo	Pahadi	more info.
Pag Ghoongroo Bandh Meera Naachi Thi	Darbari Kanada	more info.
Paga Ghungharu Bole Chananana Chanh	Malkauns	more info.
Pagadi Sambhal Jhatta	Bhairavi	more info.
Pal Do Pal Ka Saath Hamara	Kedar	more info.
Pal Pal Hai Bharee	Jaunpuri	more info.
Pan Kaye Saiyyan Humaro	Kalyan	more info.
Panchhi Banu Udti Firun Mast Gagan Men	Bhupali	more info.
Panchhi Bawra Chhand Se Prit Lagaye	Kedar	more info.
Pankh Hote To Ud Ati	Bhupali	more info.
Para Para Hua Pairahan-E-Jaan	Kirwani	more info.
Parbaton Ke Pedon Par Shaam Ka Basera Hai	Pahadi	more info.
Payalwali Dekhna	Maru Bihag	more info.
Payeliya Banvari	Marwa	more info.
Phir Kahin Koi Phul Khila	Desh	more info.
Phir Kisi Raha Guzar Par Shayad	Bhairavi	more info.
Phir Na Kije Meri Gustakh Nigaon	Kalyan	more info.
Phool Gendava Na Maaro	Bhairavi	more info.
Phulon Ke Rang Se	Pahadi	more info.
Pi Ke Ghar Aaj Pyari Dulhaniya Chali (a.k.a. Pyari Dulhaniya)	Pilu	more info.
Pilichindi Andala Baala	Janasamohini	more info.
Piya Dekhan Ko Tarsein	Bageshri	more info.
Piya Milan Ki Aasre	Shivaranjani	more info.
Piya Nahin Aye Sakhi	Kalavati	more info.
Piya Piya Bole Mora Kangana	Mand	more info.
Piya Piya Na Lage Mora Jiya	Pilu	more info.
Piya Te Kaha	Asavari	more info.
Piya Tose Naina Lage Re	Khammaj	more info.
Poochhta Jaa Mere Marghatse Guzarne Waley	Bageshri	more info.
Prabhu Tero Nam Jo Dhyae Phal Paye	Dhani	more info.
Prabhu Charanon Men	Shri (Shree)	more info.
Prabhuji	Pilu	more info.
Prem Jogan Ban Ke	Sohani	more info.
Prem Lagana	Puria Dhanashri	more info.
Premika Ne Pyar Se	Nattakurunji	more info.
Preet Ye Kaisi Bol Re Duniya	Pahadi	more info.
Pritam Aan Milo	Kalyan	more info.
Pritam Daras Dikhao	Lalit	more info.
Puchho Na Kaise Maine Rain Bitai	Ahir Bhairav	more info.
Pukarta Chala Hun Main	Kirwani	more info.
Pyaar Hua Ikraar Hua	Bhairavi	more info.
Pyar Bhare Do Sharmeele	Kafi	more info.
Pyar Hamara Munna	Brindavani Sarang	more info.
Pyar Ke Pal Chin	Shivaranjani	more info.
Pyar Ki Aag men Tan Badan	Darbari Kanada	more info.
Pyar Mein Hota Hai Kya Jadoo	Kalyan	more info.
Pyari Dulhaniya (a.k.a. Pi Ke Ghar Aaj Pyari Dulhaniya Chali)	Pilu	more info. 
Qarar Lootne Wale Qarar Ko Terse	Kafi	more info.
Raat Bhar Ka Hai Maheman Andhera	Jogiya	more info.
Raat Ka Sama Jhume Chandrama	Pahadi	more info.
Radha Jaye Na	Maru Bihag	more info.
Radha Na Bole Na Bole	Bageshri	more info.
Radhike Tune Bansari Churaiye	Adana	more info.
Raghupati Raghav Raja Ram	Gara	more info.
Raha Gardishon Men Haradam	Darbari Kanada	more info.
Rahe Na Rahe Ham Mahaka Karenge	Pahadi	more info.
Raina Biti Jaye, Shyam Na Aye	Todi	more info.
Raja Ki Ayegi Baraat	Bhairavi	more info.
Ram Ka Gun Gaan Kariye	Ahir Bhairav	more info.
Ram Teri Ganga Maili Ho Gayi...	Ahir Bhairav	more info.
Ramiya Vastaavaiya	Bhairavi	more info.
Ranjish Hi Sahi, Dil Hi Dukhane Ke Liye Aa	Kalyan	more info.
Rasika Balma	Shuddha Kalyan	more info.
Rasm-e-Ulfat Ko Nibhaen To Nibhaen Kaise	Madhuvanti	more info.
Re Man Sur Mein Ga	Kalyan	more info.
Re Re Bahar Ayi	Bahar	more info.
Rim Jhim Rim Jhim Pere Phawar Tera Mera Nit Ka Pyar	Kafi	more info.
Rimjhim Ke Geet Savan Gaye Hai	Shivaranjani	more info.
Ritu Aye Ritu Jaye	Gaurd Sarang	more info.
Roshan Huyi Raat	Anandbhairavi	more info.
Roz Roz Dali Dali Kya Likh Jaye	Kalyan	more info.
Rula Ke Gaya Sapna Mera	Pahadi	more info.
Rumajhuma Rumajhuma Chala Tihari	Shankara	more info.
Rut Aa Gayi Re, Rut Chha Gayi Re	Puria Dhanashri	more info.
Ruth Ke Tum To Chal Diye	Hemant	more info.
Saajan A Jao	Shivaranjani	more info.
Saaki - see Saqi	 	 
Saavan Aye Ya Na Aye	Brindavani Sarang	more info.
Saawan Rut Aaye Dekho Balam	Gaur Sarang	more info.
Saaz Ho Tum Avaaz Hun Main	Patdeep	more info.
Sab Kuch Luta Ke Hosh Men Aaye To Kya Kiya	Rageshri	more info.
Sab Kuch Sikha Hamne	Bhairavi	more info.
Sach Kehti Hai Duniya	Pilu	more info.
Sainya Bina Ghar Suna	Pahadi	more info.
Sainya Ja Ja Mose Na Bolo Kahe Ko Neha Lagaye	Desh	more info.
Sajan Bina Neend Na Ave	Kedar	more info.
Sajan Ki Galiyan Chod Chale	Pahadi	more info.
Sajna Sang Kahe Neha Lagae	Tilang	more info.
Sajna, Sajna Kahe Bhul Gaye Din Pyar Ke	Bhairavi	more info.
Sajna Sajna O Sajna	Bhairavi	more info.
Sakal Bana Gagan	Bahar	more info.
Sakhi Re Mera Man Uljhe Tan Dole	Pahadi	more info.
Sakhi Re Suun Bole Papiha	Khammaj	more info.
Saki - see Saqi	 	 
Salam-e-Hasrat Kabool	Kalyan	more info.
Salamat Raho	Pahadi	more info.
Samay O Dhire Chalo	Bhimpalasi	more info.
San Sanna Sanna Sanna, Jao Re O Pavan	Chandrakauns	more info.
Sanam Tu Bevafa Ke Namse	Kalavati	more info.
Sanjh Dhale Gagan Tale Hum Kitane Ekaki	Vibhas	more info.
Sansaar Ki Har Shay Ka	Bhupali	more info.
Sansar Hai Ek Nadiya Dukh Sykh	Shivaranjani	more info.
Sansar Se Bhage Phirte Ho	Kalyan	more info.
Sanvare Rang Rachi	Bhupali	more info.
Sanware Mata Ja	Adana	more info.
Sanvare Sanvare	Bhairavi	more info.
Sapt Suran Teen Gram	Kalyan	more info.
Sapno Se Bhare Naina	Bhairavi	more info.
Saqi Ki Har Nigah Pe	Todi	more info.
Saqiya Aaj Mujhe Nind Nahi Ayegi	Bhairavi	more info.
Sar Pe Kaddam Ki Chainya	Bhairavi	more info.
Saranga Teri Yaad Men	Kalyan	more info.
Sare Jahanse Achcha	Pahadi	more info.
Sare Ke Sare Ga Ma Ko Lekar Gate Chale	Alhiya Bilawal	more info.
Sarfaroshi Ki Tammana	Darbari Kanada	more info.
Satyam Shivam Sundaram	Darbari Kanada	more info.
Sau Bar Janam Lenge	Kaushik Kanada	more info.
Savan Aye, Savan Jaye	Shivaranjani	more info.
Savan Ka Mahina, Pavan Kare Sor	Pahadi	more info.
Savan Ke Jhule Pade Tum Chale Aao	Pahadi	more info.
Savan Ki Raat Kari Kari	Malkauns	more info.
Savere Ka Suraj Tumhare Liye Hai	Kalyan	more info.
Sayonara, Sayonara	Bhupali	more info.
Sham Dhale Jamuna Kinare	Khammaj	more info.
Sham Dhale Khidaki Tale	Pahadi	more info.
Sharabi, Sharabi Ye Savan Ka Mausam	Gaur Malhar	more info.
Shairana Si Hai Zindagi Ki Faza	Darbari Kanada	more info.
Sheesha-e-Dil Itna Na Uchha Lo	Bhairavi	more info.
Shikayat Hai	Bhairavi	more info.
Shola Hun Bhadakne Ki Gujarish Nahin Karta	Kalyan	more info.
Shola Tha Jal Bujha Hun	Kirwani	more info.
Shree Ram-Chandra Kripalu Bhajamana (#1)	Kalyan	more info.
Shree Ram-Chandra Kripalu Bhajamana (#2)	Hamir	more info.
Shubh Ghadi Aai	Bageshri	more info.
Shubhadina Ayo Rajadulara	Rageshri	more info.
Shyam Teri Bansi Pukare Radha Naam	Charukesi	more info.
Sikandar Bhi Aaye...Na Koi Raha	Bhairavi	more info.
Sine Men Sulaghate Hai Arman	Kalyan	more info.
So Ja Rajkumari So Ja	Jhinjhoti	more info.
Sochenge Tumhe Pyaar Kare Ke Nahin	Kalyan	more info.
Sochte Aur Jaagte Sansonka Ek Dariyaa Hun Mein	Kalyan	more info.
Sola Baras ki Baali Umar ko Salam	Ahir Bhairav	more info.
Sri - see Shree	 	 
Subah Aur Sham Kaam Hi Kaam	Kalavati	more info.
Sudh Bisar Gai Aja	Hemant	more info.
Suhani Beriya Beeti Jay	Bihag / Hamir	more info.
Suhani Chaandni Raaten Hamen Sone Nahin Deti	Darbari Kanada	more info.
Suhani Raat Dhal Chuki	Pahadi	more info.
Sun Le Bapu Ye Paigham	Bhairavi	more info.
Sun More Sajnasee - see Mohe Jana Hai Pike Nazariya	 	 
Sun Ri Pavan, Pavan Puravaiya	Bhairavi	more info.
Sun Ri Sakhi Mohe Sajna Bulaye - see Mohe Jana Hai Pike Nazariya	 	 
Sun Wanjli Di Mithri Taanway	Kafi	more info.
Sunai Deti Hai Jiski Dhadkan (A.K.A Zihaal-e-Mastii, Makun-b-Ranjish)	Bhairavi	more info.
Suni Jo Unke Aane Ki Aahat	Kalyan	more info.
Suni Suni Saaj Ki Sitar Par	Jaijaivanti	more info.
Suno Chhoti Si Gudiya Ki Lambi Kahani	Bhairavi	more info.
Supna Bana Sajana Aye	Kalyan	more info.
Sur Badale Kaise, Kaise Dekho Kismat Ki Shahana	Bhairavi	more info.
Sur Ki Gati Main Kya Janun	Hamir	more info.
Sur Na Saje Kya Gaon Main	Pilu	more info.
Surmayi Akhiyon Mein Nanha Munna Ek Sapna De Jaa Re	Pilu	more info.
Takdir Ka Fasaana	Desh	more info.
Tan Ranga Lo Ji Aaj Man Ranga Lo Baraso Re	Megh Malhar	more info.
Tasvir Banaata Hun, Tasvir Nahin Banati	Pahadi	more info.
Tera Chehra	Kalyan	more info.
Tere Dar Pe Ayaa Hun, Kuchh Karke Jaunga	Darbari Kanada	more info.
Tera Jadu Na Chalega	Bhairavi	more info.
Tera Jana	Bhairavi	more info.
Tere Bharose He Nandalala	Pahadi	more info.
Tere Bheege Badan Ki Kushboo Se	Kafi	more info.
Tere Bin Soone Nayan Hamare	Pilu	more info.
Tere Bina Jiya Na Lage	Bhairagi Bhairav	more info.
Tere Bina Sajna Lage Na Jiya Hamar	Khammaj	more info.
Tere Husn Ki Kya Taarif Karun	Kalyan	more info.
Tere Mere Bich Mein	Shivaranjani	more info.
Tere Mere Sapne Ab Ek Rang Hain	Gara	more info.
Tere Naina Talash Kare Jise	Chayanat	more info.
Tere Nainon Ne Chori Kiya	Pahadi	more info.
Tere Pyar Ka Aasra	Pilu	more info.
Tere Pyar Mein Dildar	Bihag	more info.
Tere Sadke Balama	Bhimpalasi	more info.
Tere Sur Aur Mere Geet	Bihag	more info.
Teri Ankhon Ke Siva Duniyan Mein	Jhinjhoti	more info.
Teri Duniya Mein Dil Lagta Nahin	Darbari Kanada	more info.
Teri Nigahon Pe Mar	Bhairavi	more info.
Teri Ummid Tera Intzaar Karte Hai	Charukesi	more info.
Teri Yaad Dil Se Bhulane	Tilak Kamod	more info.
Thandanana	Vibhas	more info.
Thukade Hain Mere Dil Ke	Pahadi	more info.
Thumak Chalat Ramchandra, Baajat Paijaniya	Jhinjoti	more info.
Tod Diya Dil Mera Tune Ai Bewafa	Pahadi	more info.
Tora Man Bada Papi Sanvariya Re	Pahadi	more info.
Tora Man Darpan Kahalay	Darbari Kanada	more info.
Tori Jay Jay Karatara	Puria Dhanashri	more info.
Tose Naina Lage (a.k.a. Javeda Zindagi)	Kirwani	more info.
Tu Chanda Main Chandani	Mand	more info.
Tu Chhupi Hai Kahan	Malkauns	more info.
Tu Ganga Ki Mauj Main Jamunaa Ka Dhaaraa	Bhairavi	more info.
Tu Hai Mera Prem Devta	Lalit	more info.
Tu Hai Phool Mere Gulshan Ka	Bhimpalasi	more info.
Tu Hindu Banega Na Musalman Banega	Bhairavi	more info.
Tu Jahan Jahan Chalega	Nand	more info.
Tu Jo Mere Sur Men	Pilu	more info.
Tu Jo Nahin Hai to Kuch Bhi Nahin Hai	Darbari Kanada	more info.
Tu Pyar Ka Sagar Hai	Darbari Kanada	more info.
Tujhko Mera Pyar Pukare	Pahadi	more info.
Tujhko Pukare Mera Pyar	Pahadi	more info.
Tum Agar Mujhko	Kalyan	more info.
Tum Apna Ranj O Gam, Apni Pareshani Mujhe De Do	Pahadi	more info.
Tum Bin Jeevan Kaise Jeevan, Phul Khile to Dil Murajhaaye	Hemant	more info.
Tum Bin Jivan Kaise Bita	Kalyan	more info.
Tum Gagan Ke Chandrama Ho	Kalyan	more info.
Tum Hi Ho Mata, Pitaa Tumhi Ho	Bhairavi	more info.
Tum Mile Dil Khile	Bhimpalasi	more info.
Tum Mujhe Bhul Bhi Jao To Ye Haq Hai Tumko	Pahadi	more info.
Tum Mujhe Yun Bhula Na Paoge	Jhinjhoti	more info.
Tum Nahin, Gam Nahin, Sharab Nahin	Kafi	more info.
Tum Sang Akhiyan Lagake	Brindavani Sarang	more info.
Tum Se Milkar, Na Jane Kyun, Aur Bhi Kuchh Yaad Aata Hai	Shivaranjani	more info.
Tum To Pyar Ho Sajna	Maru Bihag	more info.
Tumhara Pyar Chahiye Mujhe	Kafi	more info.
Tumhare Bin Ji Na Lage Gharmen	Tilak Kamod	more info.
Tumhare Sang Main Bhi Chalungi	Bhairavi	more info.
Tumhe Zindagi Ke Ujale Mubarak	Darbari Kanada	more info.
Tumhein Aaj Maine Dekha	Kalyan	more info.
Tumhen Aur Kya Dun Main Dil Ke Sivay	Bhairavi	more info.
Tumhi Mere Mit Ho	Kirwani	more info.
Tumhi Ne Mujhko Prem Sikhya	Bhimpalasi	more info.
Tumko Dekha To Ye Khayal Aya	Kamod	more info.
Tumne Kya Kya Kiya Hai Hamare Liye	Puria Dhanashri	more info.
Tumse Hi Ghar Ghar Kahalaya	Darbari Kanada	more info.
Tute Na Dil Tute Na	Bhairavi	more info.
Tuthe Hue Khvabon Ne	Darbari Kanada	more info.
Ud Ja Bhanwar Maya Kamal Ka	Darbari Kanada	more info.
Udajare Ja Re Kaga	Bhinashadaj	more info.
Unape Yu Pyar Aane Laga hai	Jog	more info.
Unke Khayal Aye To Ate Chale Gaye	Gara	more info.
Unko Ye Shikayat Hai Ke Ham	Malgunji	more info.
Usko Nahin Dekha Hamne Kabhi	Pahadi	more info.
Usne Kaha Tu	see - "Baaki Kuchh Bacha To Menhagai Maar Gayi"	 
Uthaye Ja Unke Sitam Aur Jeeye Ja	Kedar	more info.
Vaadaa Kar Le Saajna	Basant Mukhari	more info.
Vahan Kaun Hai Tera, Musaphir Jayega Kahan	Pahadi	more info.
Vaishnav Jan To	Khammaj	more info.
Vande Mataramh	Desh	more info.
Vikal Mora Manva, Tum Bin Hai	Pilu	more info.
Vo Dil Kahan Se Laun	Pahadi	more info.
Vo Na Ayenge Palatkar	Khammaj	more info.
Vrindavan Ka Krishna Kanhaiya	Pahadi	more info.
Waqt Karta Jo Wafa Aap Hamare Hote	Ahir Bhairav	more info.
Waqt Se Din Aur Raat	Bhairavi	more info.
Watan Pe Jo Fida Hoga	Gujari Todi	more info.
Woh Dekhen To Unki Inayat	Gaur Sarang	more info.
Woh Has Ke Mile Humse	Kalyan	more info.
Woh Jab Yaad Aye, Bahut Yaad Aye	Kalyan	more info.
Woh Mohabbat Woh Wafaayen	Darbari Kanada	more info.
Woh Sham Kuchh Ajib Thi	Kalyan	more info.
Yaad Rahega, Pyarka Yeh Rangin Zamanaa Yaad Rahega	Kalyan	more info.
Yaad Teri Aayegi	Shivaranjani	more info.
Yad Na Jaye, Bite Dinon	Kirwani	more info.
Yad Piya Ki Aye	Bhinashadaj	more info.
Yahi Arman Lekar Aaj Apne Ghar Se Ham Nukale	Tilang	more info.
Yahi Hai Woh Saanj Aur Savera (A.K.A. Jiske Liye Tadape Ham)	Bhairavi	more info.
Yara Dildara Mera Dil Karta	Pahadi	more info.
Ye Chaman Hamra Apna Hai	Kalyan	more info.
Ye Dil Aur Unki	Pahadi	more info.
Ye Dil Yeh Paagal Dil Mera Kyon Bujh Gaya Awaaragi	Bhairavi	more info.
Ye Duniya Hai,Yanha Dil Ka	Bhairavi	more info.
Ye Hariyali Aur Ye Raasta	Bhairavi	more info.
Ye Kahani Hai Diye Ki Aur Tufana Ki	Malkauns	more info.
Ye Na Thi Hamri Kismat	Bhimpalasi	more info.
Ye Raat Bheegi Bheegi	Kirwani	more info.
Ye Raten Ye Mausam Nadi Ka Kinara	Kirwani	more info.
Ye Sham Ki Tanahaiyan	Shuddha Kalyan	more info.
Ye Vadiyan Phizaen Bula Rahi Hain Tumhe	Pahadi	more info.
Yeh Aaine Se Akele Men Guftagu Kya Hai	Bhimpalasi	more info.
Yeh Barkha Bahar Sautaniya Ke Dwar	Pahadi	more info.
Yeh Dil Ki Lagi Kam Kya Hogi	Jaijaivanti	more info.
Yeh Hava...Yeh Phiza...Aa Bhi Jaa	Bhupali	more info.
Yeh Kya Jagah Hai Doston	Bihag	more info.
Yeh Raat Yeh Chandni	Kafi	more info.
Yeh Tara Voh Tara	Kalavati	more info.
Yeh Zindagi Ke Mele	Bhairavi	more info.
Yoon Neend Se	Shyam Kalyan	more info.
Zamaane Ka Dastur Hai Ye Purana	Kalyan	more info.
Zara Si Ahat Hoti Hai...Kahin Yeh Woh To Nahin	Kalyan	more info.
Zara Sun Hasina	Pahadi	more info.
Zindagi Aaj Mere Nam Se Sharamati Hai	Jaijaivanti	more info.
Zindagi Bhar Nahin Bhulegi Vo Barsaat Ki Raat	Kalyan	more info.
Zindagi Bhara Gam Judai Ka Mujhe	Malkauns	more info.
Zindagi Ke Safar Men Guzar Jate Hain Jo Makam	Bihag	more info.
Zindagi Khwab Hai	Pilu	more info.
Zindagi Ko Sanvarana Hoga	Ahir Bhairav	more info.
Zindagi Men To Sabhi Pyar Kiya Karte Hai	Bhimpalasi	more info.